create_mt_time_us,malloc_time_us,processing_time_us,free_time_us,join_mt_time_us,total_time_us,threads
0,9909,3762,19,0,13690,8
0,9756,3761,18,0,13535,8
0,9749,3783,18,0,13550,8
0,9763,3786,18,0,13567,8
0,9791,3788,18,0,13597,8
0,9824,3737,18,0,13579,8
0,9729,3795,19,0,13543,8
0,10049,3877,19,0,13945,8
0,10229,3990,19,0,14238,8
0,10280,4007,20,0,14307,8
