create_mt_time_us,malloc_time_us,processing_time_us,free_time_us,join_mt_time_us,total_time_us,threads
0,8246,43303,6,0,51555,11
0,5605,43740,6,0,49351,11
0,5648,43955,6,0,49609,11
0,5578,43756,6,0,49340,11
0,5485,43529,7,0,49021,11
0,5482,44333,7,0,49822,11
0,5600,46920,6,0,52526,11
0,5477,46316,5,0,51798,11
0,5459,46019,7,0,51485,11
0,5579,45973,6,0,51558,11
