create_mt_time_us,malloc_time_us,processing_time_us,free_time_us,join_mt_time_us,total_time_us,threads
0,9009,38106,7,0,47122,11
0,5432,37370,7,0,42809,11
0,5420,37479,8,0,42907,11
0,5493,37712,6,0,43211,11
0,5357,37527,8,0,42892,11
0,5391,37799,6,0,43196,11
0,5416,37708,5,0,43129,11
0,5341,37614,7,0,42962,11
0,5477,37413,7,0,42897,11
0,5548,37976,6,0,43530,11
