create_mt_time_us,malloc_time_us,processing_time_us,free_time_us,join_mt_time_us,total_time_us,threads
0,6265997,311,3294,0,6269602,16
0,6277461,315,3101,0,6280877,16
0,6302298,313,3186,0,6305797,16
0,6268951,322,3345,0,6272618,16
0,6281344,315,3189,0,6284848,16
0,6255532,317,3240,0,6259089,16
0,6175443,319,3366,0,6179128,16
0,6307433,312,3565,0,6311310,16
0,6289752,321,3712,0,6293785,16
0,6282383,311,3342,0,6286036,16
