create_mt_time_us,malloc_time_us,processing_time_us,free_time_us,join_mt_time_us,total_time_us,threads
0,6675917,2965150,1205,0,9642272,8
0,6702418,2900298,1377,0,9604093,8
0,6746377,2972634,1420,0,9720431,8
0,6760531,2928612,1335,0,9690478,8
0,6759203,3013410,1605,0,9774218,8
0,6766639,2932695,1596,0,9700930,8
0,6754624,3005722,1513,0,9761859,8
0,6742569,2952613,1316,0,9696498,8
0,6750333,3027388,1613,0,9779334,8
0,6725509,2960185,1453,0,9687147,8
