create_mt_time_us,malloc_time_us,processing_time_us,free_time_us,join_mt_time_us,total_time_us,threads
0,6153,3643,18,0,9814,8
0,6167,8582,19,0,14768,8
0,6261,3654,19,0,9934,8
0,6192,3636,18,0,9846,8
0,6026,3607,18,0,9651,8
0,6053,3674,18,0,9745,8
0,6065,3648,18,0,9731,8
0,6066,3671,18,0,9755,8
0,6124,3767,19,0,9910,8
0,6349,3836,19,0,10204,8
