create_mt_time_us,malloc_time_us,processing_time_us,free_time_us,join_mt_time_us,total_time_us,threads
0,7196135,2924344,983,0,10121462,8
0,7206418,2914459,1060,0,10121937,8
0,7225187,2931453,1184,0,10157824,8
0,7205154,2930058,1078,0,10136290,8
0,7230387,2928420,1120,0,10159927,8
0,7206439,2938557,1125,0,10146121,8
0,7209560,2931195,1067,0,10141822,8
0,7211684,2955279,1131,0,10168094,8
0,7188790,2931867,1079,0,10121736,8
0,7199376,2936609,1164,0,10137149,8
