create_mt_time_us,malloc_time_us,processing_time_us,free_time_us,join_mt_time_us,total_time_us,threads
0,3709747,930239,7485,0,4647471,11
0,3699273,932767,7756,0,4639796,11
0,3702681,938847,8367,0,4649895,11
0,3715140,938358,8823,0,4662321,11
0,3699170,939514,9364,0,4648048,11
0,3760725,939506,10493,0,4710724,11
0,3862863,936120,9251,0,4808234,11
0,3893773,940138,8939,0,4842850,11
0,3703945,940068,8906,0,4652919,11
0,3714755,938187,9209,0,4662151,11
