create_mt_time_us,malloc_time_us,processing_time_us,free_time_us,join_mt_time_us,total_time_us,threads
0,3128,26912,7,0,30047,11
0,3147,25618,5,0,28770,11
0,3246,24315,6,0,27567,11
0,3180,24362,5,0,27547,11
0,3089,23108,6,0,26203,11
0,3144,23888,6,0,27038,11
0,3099,23418,6,0,26523,11
0,3188,24968,6,0,28162,11
0,3145,25359,5,0,28509,11
0,3130,23592,5,0,26727,11
