create_mt_time_us,malloc_time_us,processing_time_us,free_time_us,join_mt_time_us,total_time_us,threads
0,6130020,325,2912,0,6133257,16
0,6284934,329,2939,0,6288202,16
0,6339516,326,2901,0,6342743,16
0,6335822,324,2883,0,6339029,16
0,6234054,322,2909,0,6237285,16
0,6149028,342,2700,0,6152070,16
0,6174766,328,2839,0,6177933,16
0,6145563,331,2898,0,6148792,16
0,6167747,328,2814,0,6170889,16
0,6302073,329,2841,0,6305243,16
