create_mt_time_us,malloc_time_us,processing_time_us,free_time_us,join_mt_time_us,total_time_us,threads
0,6807,14651,35,0,21493,16
0,6796,5071,35,0,11902,16
0,6815,5060,35,0,11910,16
0,6813,5099,36,0,11948,16
0,6812,19886,35,0,26733,16
0,6964,30452,34,0,37450,16
0,6906,10008,36,0,16950,16
0,6869,5095,36,0,12000,16
0,6839,5084,35,0,11958,16
0,6835,5129,37,0,12001,16
