create_mt_time_us,malloc_time_us,processing_time_us,free_time_us,join_mt_time_us,total_time_us,threads
0,11983974,2646730,3570,0,14634274,16
0,11566707,2653734,3591,0,14224032,16
0,11577177,2689273,3597,0,14270047,16
0,11566858,2619499,3579,0,14189936,16
0,11555595,2624760,3598,0,14183953,16
0,11550654,2617158,3568,0,14171380,16
0,11627826,2672448,3556,0,14303830,16
0,11578885,2673555,3828,0,14256268,16
0,11603146,2678083,3752,0,14284981,16
0,11605019,2628817,3744,0,14237580,16
