create_mt_time_us,malloc_time_us,processing_time_us,free_time_us,join_mt_time_us,total_time_us,threads
0,7210,130108,7,0,137325,1
0,7432,57470,14,0,64916,1
0,7239,58004,19,0,65262,1
0,7373,59415,14,0,66802,1
0,7114,55948,14,0,63076,1
0,7174,55771,14,0,62959,1
0,7170,56311,14,0,63495,1
0,7221,55987,14,0,63222,1
0,7302,56092,14,0,63408,1
0,8163,55838,14,0,64015,1
