create_mt_time_us,malloc_time_us,processing_time_us,free_time_us,join_mt_time_us,total_time_us,threads
0,28198,38924,14,0,67136,8
0,12580,38873,21,0,51474,8
0,12330,38446,21,0,50797,8
0,12306,38499,21,0,50826,8
0,12309,38219,21,0,50549,8
0,12312,36075,21,0,48408,8
0,12284,43134,21,0,55439,8
0,12318,36810,22,0,49150,8
0,12290,43024,22,0,55336,8
0,13882,31264,23,0,45169,8
