create_mt_time_us,malloc_time_us,processing_time_us,free_time_us,join_mt_time_us,total_time_us,threads
0,11712,23916,27,0,35655,16
0,10011,18490,35,0,28536,16
0,9952,6592,35,0,16579,16
0,9995,6515,36,0,16546,16
0,9923,6639,37,0,16599,16
0,10002,6631,36,0,16669,16
0,10108,6420,35,0,16563,16
0,10061,6419,36,0,16516,16
0,10017,6556,35,0,16608,16
0,9981,6396,36,0,16413,16
