create_mt_time_us,malloc_time_us,processing_time_us,free_time_us,join_mt_time_us,total_time_us,threads
0,21754,4497,11,0,26262,8
0,9957,4444,19,0,14420,8
0,9782,4364,19,0,14165,8
0,9743,4435,18,0,14196,8
0,9763,4422,19,0,14204,8
0,9756,4415,18,0,14189,8
0,9699,4469,18,0,14186,8
0,10032,4701,19,0,14752,8
0,10419,4882,19,0,15320,8
0,10615,4822,19,0,15456,8
