create_mt_time_us,malloc_time_us,processing_time_us,free_time_us,join_mt_time_us,total_time_us,threads
0,3545,1033,5,0,4583,11
0,3463,991,4,0,4458,11
0,3820,988,5,0,4813,11
0,3614,985,5,0,4604,11
0,3619,1007,5,0,4631,11
0,3507,979,4,0,4490,11
0,3411,998,4,0,4413,11
0,3391,935,4,0,4330,11
0,3675,969,5,0,4649,11
0,3598,1007,5,0,4610,11
