create_mt_time_us,malloc_time_us,processing_time_us,free_time_us,join_mt_time_us,total_time_us,threads
0,3695621,1026399,9134,0,4731154,11
0,3707065,1025316,9454,0,4741835,11
0,3694298,1021040,9088,0,4724426,11
0,3704128,1057965,8613,0,4770706,11
0,3697160,1025676,9038,0,4731874,11
0,3747655,1025759,9206,0,4782620,11
0,3781433,1031043,9687,0,4822163,11
0,3804300,1026038,8908,0,4839246,11
0,3793051,1029332,9778,0,4832161,11
0,3700719,1029182,9767,0,4739668,11
