create_mt_time_us,malloc_time_us,processing_time_us,free_time_us,join_mt_time_us,total_time_us,threads
0,5180,30987,7,0,36174,11
0,5071,36063,5,0,41139,11
0,5093,29095,5,0,34193,11
0,5024,29471,5,0,34500,11
0,4924,29130,6,0,34060,11
0,4922,30020,6,0,34948,11
0,4960,31656,6,0,36622,11
0,4991,30996,5,0,35992,11
0,4954,30555,6,0,35515,11
0,5053,31644,6,0,36703,11
